####################
#                  #
#  c               #
#                  #
#                  +
#                  +
#                  #
#                  #
#                ###
##########++######  
