SIZE: 10 20

BEGIN 
####################
#                  #
#  c               #
#                  #
#                  +
#                  +
#                  #
#                  #
#                  #
##########++########
END
